each	/i:tʃ/	a./pron.各,各自的,每
eager	/'i:ɡə/	a.(for)渴望的,热切的
eagle	/'i:ɡl/	n.鹰
ear	/iə/	n.耳,耳朵;听力,听觉;穗
early	/'ə:li/	a.早的,早期的,及早的ad.早,在初期
earn	/ə:n/	v.赚得,挣得,获得
earnest	/'ə:nist/	a.热心的,诚挚的n.热心;真挚;定金;认真
earth	/ə:θ/	n.地球;陆地;泥土,土壤;尘世,人间
earthquake	/'ə:θkweik/	n.地震
ease	/i:z/	v.减轻;使舒适,使安心n.容易;舒适,悠闲
east	/i:st/	n.东,东方,东部a.东方的,东部的
Easter	/ˈiːstə(r)/	n.复活节
eastern	/'i:stən/	a.东方的,东部的
easy	/'i:zi/	a.容易的,不费力的,安逸的,宽裕的
eat	/i:t/	vt.吃,喝vi.吃饭,吃东西
ebb	/eb/	vi.衰退,减退n.处于低潮,处于衰退状态
eccentric	/ik'sentrik/	a.古怪的,怪癖的,异乎寻常的n.古怪的人
echo	/'ekəu/	v./n.回声,反响,共鸣
eclipse	/i'klips/	n.日食,月食
ecology	/i:'kɔlədʒi/	n.生态学
economic	/,i:kə'nɔmik/	a.经济(上)的,经济学的
economical	/,i:kə'nɔmikəl/	a.节约的,经济的
economics	/,i:kə'nɔmiks/	n.经济学,经济情况
economy	/i'kɔnəmi/	n.节约;经济
edge	/edʒ/	n.边,棱;刀口,刃v.侧身移动,挤进
edible	/'edibl/	a.可食用的
edit	/'edit/	v.编辑,校订
edition	/i'diʃən/	n.版,版本,版次
editor	/'editə/	n.编辑,编者
editorial	/,edi'tɔ:riəl/	n.社论a.社论的;编辑上的
educate	/'edju:keit/	v.教育,培养,训练
education	/,edju:'keiʃən/	n.教育,培养,训练
effect	/i'fekt/	n.结果;效果;影响;印象vt.招致;实现;达到
effective	/i'fektiv/	a.有效的,生效的;被实施的;给人深刻印象
efficiency	/i'fiʃənsi/	n.效率;功效
efficient	/i'fiʃənt/	a.有效的,效率高的;有能力的,能胜任的
effort	/'efət/	n.努力;成就;艰难的尝试
egg	/eɡ/	n.蛋;卵;卵形物
ego	/'i:ɡəu,'eɡəu/	n.自我,自负,利已主义;(心理学)自我意识
eight	/eit/	num.八pron.八(个,只...)
eighteen	/'ei'ti:n/	num.十八,十八个
eighty	/'eiti/	num./a.八十pron.八十(个,只...)
either	/'aiðə,'i:-/	ad.也(不)pron.两者之一a.(两者中)任一的
eject	/i'dʒekt,'i:dʒekt/	v.喷射,排出;驱逐
elaborate	/i'læbərət,i'læbəreit/	v./a.精心制作(的);详细阐述(的)
elapse	/i'læps/	vi．(时间)溜走;(光阴)逝去
elastic	/i'læstik/	a.弹性的n.松紧带,橡皮圈
elbow	/'elbəu/	n.肘,(衣服的)肘部vt.用肘推,用肘挤
elder	/'eldə/	a.年长的,资格老的n.长辈
elderly	/'eldəli/	a.较老的,年长的n./the～/到了晚年的人
elect	/ɪˈlekt/	v.选举,推选;选择,作出选择
electric	/i'lektrik/	a.电的,导电的,电动的
electrical	/i'lektrikəl/	a.电的,电学的
electrician	/,ilek'triʃən/	n.电学家,电工
electricity	/,ilek'trisəti/	n.电,电流;电学
electron	/i'lektrɔn/	n.电子
electronic	/,ilek'trɔnik/	a.电子的
elegant	/'eliɡənt/	a.优雅的;端庄的;雅致的
element	/'elimənt/	n.元素;要素;成分;元件;自然环境
elementary	/,eli'mentəri/	a.初步的;基本的;/化/元素的;自然力的
elephant	/'elifənt/	n.(动物)象
elevate	/'eliveit/	vt.举起,提拔,振奋,提升...的职位
elevator	/'eliveitə/	n.电梯,升降机
eleven	/i'levən/	num.十一pron./a.十一(个,只...)
eligible	/'elidʒəbl/	a.符合条件的;(尤指婚姻等)合适(意)的
eliminate	/i'limineit/	vt.除去;淘汰;排(删,消)除;削减(人员)
elite	/ei'li:t,i'li:t/	n.<法>/集合名词/精华;精锐;中坚分子
eloquent	/'eləkwənt/	a.雄辩的,有说服力的;善辩的,口才流利的
else	/els/	ad.其它,另外,别的;/与or连用/否则
elsewhere	/,els'hwεə/	ad.在别处,向别处
e-mail	/iː meɪl/	n.(electronicmail)电子信函,电子邮件
embark	/em'bɑ:k,im-/	v.(使)上船(或飞机,汽车等);着手,从事
embarrass	/im'bærəs/	vt.使困窘,使局促不安;阻碍,麻烦
embassy	/'embəsi/	n.大使馆;大使及其随员
embed	/im'bed/	vt.把…嵌(埋、插)入,扎牢;使深留脑中
embody	/im'bɔdi/	vt.具体表达,使具体化;包含,收录
embrace	/im'breis/	v.拥抱;包含;包围;环绕;采用;接受
emerge	/i'mə:dʒ/	vt.显现,浮现;暴露;形成;
emergency	/i'mə:dʒənsi/	n.紧急情况,突然事件,非常时刻
emigrate	/'emiɡreit/	v.(反)immigrate;(to,from)自本国移居他
eminent	/'eminənt/	a.显赫的;杰出的;有名的;优良的
emit	/i'mit/	vt.发出;放射;吐露;散发;发表;发行
emotion	/i'məuʃən/	n.情绪,情感,感情
emperor	/'empərə/	n.皇帝
emphasis	/'emfəsis/	n.强调,重点
emphasize	/'emfəsaiz/	v.(emphasise)强调
empire	/'empaiə/	n.帝国
empirical	/em'pirikəl/	a.凭经验(或观察)的,经验主义的
employ	/im'plɔi/	n./v.雇用;用,使用
employee	/,emplɔi'i:,em'plɔii:/	n.雇工,雇员
employer	/im'plɔiə/	n.雇主
employment	/im'plɔimənt/	n.雇用;使用;工作,职业
empty	/'empti/	a.空的;空洞的v.倒空,使成为空的
enable	/i'neibl/	v.使能够,使成为可能;授予权利或方法
enclose	/in'kləuz/	v.围住,圈起,封入
enclosure	/in'kləuʒə/	n.围住,圈起,封入,附件
encounter	/in'kauntə/	n./v.遇到,遭遇
encourage	/in'kʌridʒ/	v.鼓励,怂恿
encyclopedia	/en,saikləu'pi:djə/	n.(encyclopaedia)百科全书
end	/end/	n.末端,端,梢;目标,目的v.终止,结束
endeavor	/in'devə/	v./n.(endeavour)努力,尽力,力图
ending	/'endiŋ/	n.结尾,结局
endow	/in'dau/	vt.资助,捐赠;(with)给予,赋予
endurance	/in'djuərəns/	n.忍耐(力),持久(力),耐久(性)
endure	/in'djuə/	v.忍受,持久,持续
enemy	/'enimi/	n.敌人,仇敌,反对者;敌人,敌军,敌国
energetic	/,enə'dʒetik/	a.精力旺盛的;积极的;有力的
energy	/'enədʒi/	n.活力,精力;能,能量
enforce	/in'fɔ:s/	v.实施,执行;强制;支持,坚持(要求,主张等)
engage	/in'ɡeidʒ/	v.(in)从事,着手;约定;使订婚;保证;雇用
engagement	/in'ɡeidʒmənt/	n.约会,约定;婚约,订婚
engine	/'endʒin/	n.发动机,引擎;火车头
engineer	/,endʒi'niə/	n.工程师
engineering	/,endʒi'niəriŋ/	n.工程学
enhance	/in'hɑ:ns,-hæns/	v.提高,增强
enjoy	/in'dʒɔi/	vt.享受…的乐趣;欣赏;喜爱
enlarge	/in'lɑ:dʒ/	vt.扩大,放大,增大
enlighten	/in'laitən/	v.启发,启蒙,教导
enormous	/i'nɔ:məs/	a.巨大的,庞大的
enough	/i'nʌf/	a.(for)足够的n.足够,充分ad.足够地
enquire	/in'kwaiə/	v.(inquire)询问,打听;调查;查问
enrich	/in'ritʃ/	v.使富足;使肥沃;装饰;加料于;浓缩
enroll	/in'rəul/	v.(enrol)招收;登记;入学;参军;成为会员
ensure	/in'ʃuə/	v.确保,保证;使安全
entail	/in'teil/	vt.使承担;需要;把(疾病等)遗传给;限定
enter	/'entə/	vt.进入;参加,加入;写入vi.进去,进来
enterprise	/'entəpraiz/	n.事业,企(事)业单位;事业心,进取心
entertain	/,entə'tein/	v.招待,款待;使娱乐;使欢乐;容纳,接受
entertainment	/,entə'teinmənt/	n.招待,款待;表演文娱节目
enthusiasm	/in'θju:ziæzəm/	n.热情,热心;狂热;积极性(for)
enthusiastic	/in,θju:zi'æstik/	a.热情的,热心的
entire	/in'taiə/	a.完全的,全部的,完整的
entitle	/in'taitl/	v.给以权利(或资格);给…称号(题名);授权
entity	/'entəti/	n.实体;存在(物);组织,机构;本质
entrance	/'entrəns/	n.入口,门口;进入;入学,入会
entrepreneur	/,ɔntrəprə'nə:/	n./法/企业家,主办人
entry	/'entri/	n.进入,入口;通道;记载,条目
envelope	/'envələup/	n.信封,信皮;封套
environment	/in'vaiərənmənt/	n.环境,外界
envisage	/in'vizidʒ/	v.想象,设想,展望,正视
envy	/'envi/	v./n.羡慕,忌妒
epidemic	/,epi'demik/	a.流行性的;传染的n.流行病;传播
episode	/'episəud/	n.一段情节;片断;(连续剧的)一集
epoch	/'i:pɔk,'epək/	n.新纪元;时代;时期;【地质】世,纪,期
equal	/'i:kwəl/	a.相等的;胜任的n.相等的事务;对手v.等于
equality	/i:'kwɔləti/	n.同等;平等;相等;等式;等同性
equation	/i'kweiʒən,-ʃən/	n.(数学)等式,方程式;(with)相等;均衡
equator	/i'kweitə/	n.赤道
equip	/i'kwip/	v.(with)装备,配备;训练
equipment	/i'kwipmənt/	n.设备,器材,装置;才能
equivalent	/i'kwivələnt/	a.(to)相等的,等价的n.相等物,等价物
era	/'iərə,'εərə/	n.时代,年代,阶段,纪元
erase	/i'reiz,i'reis/	v.擦掉;删去;消磁
erect	/i'rekt/	v.树立,建立,使竖立a.直立的,垂直的
erosion	/i'rəuʒən/	n.腐蚀,磨损;削弱,减少
erroneous	/i'rəuniəs/	a.错误的,不正确的
error	/'erə/	n.错误,过失
erupt	/i'rʌpt/	v.(尤指火山)爆发
escalate	/'eskəleit/	v.(使)逐步增长(或发展),(使)逐步升级
escape	/i'skeip/	n.逃跑,逃脱v.逃跑;避开,避免
escort	/'eskɔ:t,i'skɔ:t/	vt.护送(卫);陪同n.警卫,护送者;仪仗兵
especially	/i'speʃəli/	ad.特别,尤其,格外;专门地,主要地
essay	/'esei,e'sei/	n.文章,短文
essence	/'esəns/	n.本质,实质
essential	/i'senʃəl/	a.本质的,基本的;净化的n.本质;要素
establish	/i'stæbliʃ/	v.建立,设立;安置,使定居
establishment	/i'stæbliʃmənt/	n.建立,设立,建立的机构(或组织)
estate	/i'steit/	n.房地产;不动产;所有权;地位;生活状况
esteem	/i'sti:m/	n.尊敬,尊重vt.尊重,敬重;把…看作
estimate	/'estimeit/	v./n.估计,估价;评估
eternal	/i'tə:nəl/	n.永久的,永恒的
ethnic	/'eθnik/	a.种族的;人种学的
evacuate	/i'vækjueit/	vt.撤离,疏散,排泄,剥夺
evade	/i'veid/	vt.逃避,回避;避开,躲避
evaluate	/i'væljueit/	v.估价,评价;求…的值
evaporate	/i'væpəreit/	v.蒸发,挥发;沉淀;发射;消失
eve	/i:v/	n.(节日等的)前夜,前夕
even	/'i:vən/	ad.甚至(更)a.均匀的;平的;相等的;偶数的
evening	/'i:vniŋ/	n.傍晚,黄昏,晚上
event	/i'vent/	n.事件,事情
eventually	/i'ventʃuəli/	ad.终于,最后
ever	/'evə/	ad.曾经;永远;在任何时候;究竟
every	/'evri/	a.每一个的,每个的;每隔…的;全部的
everybody	/'evri,bədi/	pron.(everyone)每人,人人
everyday	/'evridei/	adj.每日的,日常的
everyone	/'evriwʌn/	pron.(everybody)每人,人人,各人
everything	/'evriθiŋ/	pron.每件事,一切;最重要的东西
everywhere	/'evrihwεə/	ad.到处,各处,无论何处
evidence	/'evidəns/	n.明显;显著;根据;证据;迹象
evident	/'evidənt/	a.明显的,明白的
evil	/'i:vəl/	a.邪恶的,罪恶的n.邪恶,罪恶
evoke	/i'vəuk/	vt.唤起(回忆、感情等);引起
evolution	/,i:və'lu:ʃən,,ev-/	n.进化,演变,发展,进展
evolve	/i'vɔlv/	v.(使)发展;(使)进化;(使)进展
exact	/iɡ'zækt/	a.确切的,正确的,精确的
exaggerate	/iɡ'zædʒəreit/	v.夸大,夸张
exam	/iɡ'zæm/	n.(examination)考试,测验
examine	/iɡ'zæmin/	v.检查,调查;对…进行考试
example	/iɡ'zɑ:mpl/	n.例子,实例;模范,榜样
exceed	/ik'si:d/	v.超过,胜过;越出
exceedingly	/ik'si:diŋli/	ad.极端地,非常
excel	/ik'sel/	vi.胜过其他;擅长vt.胜过,优于
excellent	/'eksələnt/	a.卓越的,极好的
except	/ik'sept/	prep.除…之外v.除外;反对
exception	/ik'sepʃən/	n.例外,除外;反对;异议
exceptional	/ik'sepʃənəl/	a.例外的,异常的
excerpt	/ek'sə:pt,'eksə:pt/	n./vt.摘录;引用
excess	/ik'ses/	a.过量的,额外的n.过量;过剩;超额;无节制
excessive	/ik'sesiv/	a.过多的;过分的;额外
exchange	/iks'tʃeindʒ/	v./n.(for)交换,兑换;交流,交易;交换台
excite	/ik'sait/	v.刺激,使激动;激发,激励
excitement	/ik'saitmənt/	n.刺激,激动,兴奋
exciting	/ik'saitiŋ/	a.令人兴奋的,使人激动的
exclaim	/ik'skleim/	v.呼喊,惊叫,大声说
exclude	/iks'klu:d/	v.拒绝,把…排除在外,排斥
exclusive	/ik'sklu:siv/	a.独占的;排他的;孤高的;唯一的;高级的
excursion	/ik'skə:ʃən/	n.短途旅行,游览;离题;/物理/偏移,漂移
excuse	/ik'skju:z,ik'skju:s/	v.原谅,宽恕,免除n.借口,辩解
execute	/'eksikju:t/	v.实行;实施;执行;完成;履行;处死
executive	/iɡ'zekjutiv/	n.总经理,董事,行政负责人a.执行的,实施的
exemplify	/iɡ'zemplifai/	v.举例证明;示范;作...的范例/榜样/
exempt	/iɡ'zempt/	a.免除的v.免除n.免税者;被免除义务者
exercise	/'eksəsaiz/	n.练习,习题;训练,锻练v.训练,锻练;行使
exert	/iɡ'zə:t/	v.尽(力),施加(压力等),努力
exhaust	/iɡ'zɔ:st/	v.使筋疲力尽,耗尽;抽完n.排气装置;废气
exhibit	/iɡ'zibit/	v.展出,陈列n.展览品,陈列品
exhibition	/,eksi'biʃən/	n.展览会;陈列,展览
exile	/'eɡzail,'eksail/	n.流放;被流放者vt.流放,放逐,把…充军
exist	/iɡ'zist/	v.存在;生存;生活
existence	/iɡ'zistəns/	n.存在,实在;生存,生活(方式)
exit	/'eksit,'eɡzit/	n.出口,通道
exotic	/,iɡ'zɔtik/	a.奇异的;异国情调的;外(国)来的
expand	/ik'spænd/	v.(使)膨胀,(使)扩张;张开,展开
expansion	/ik'spænʃən/	n.扩张,膨胀;张开,伸展
expect	/ik'spekt/	v.预期;期望,指望
expectation	/,ekspek'teiʃən/	n.预期,期望,指望
expedition	/,ekspi'diʃən/	n.远征(队),探险(队)
expel	/ik'spel/	v.把…开除;驱逐;排出;发射
expend	/ik'spend/	v.消费,花费
expenditure	/iks'penditʃə/	n.花费;(时间,金钱等的)支出,消耗
expense	/ik'spens/	n.花费,消费,消耗
expensive	/ik'spensiv/	a.花费的,昂贵的
experience	/ik'spiəriəns/	n./vt.经验;经历;体验;阅历
experiment	/ik'speriment,ek's-/	n.实验;试验v.(on)进行实验;做试验
experimental	/ek,speri'mentəl,ek's-/	a.实验(性)的,试验(性)的
expert	/'ekspə:t,ek'spə:t/	n.专家,能手a.熟练的,有经验的;专门的
expertise	/,ekspə:'ti:z/	n.专门知识(或技能等),专长
expire	/ik'spaiə,ek-/	v.期满,(期限)终止;呼气;断气,死亡
explain	/ik'splein/	v.解释,说明
explanation	/,eksplə'neiʃən/	n.解释,说明
explicit	/ik'splisit/	a.详述的,明确的;坦率的;显然的
explode	/ik'spləud/	v.(使)爆炸,(使)爆发
exploit	/'eksplɔit,ik's-/	v.开拓;开发;剥削n.功绩/勋/;业绩
explore	/ik'splɔ:/	v.勘探,探测;探究,探索
explosion	/ik'spləuʒən/	n.爆炸,爆发
explosive	/ik'spləusiv/	a.爆炸(性)的,爆发(性)的n.爆炸物,炸药
export	/ik'spɔ:t,'ekspɔ:t/	v./n.输出,出口n.出口商品
expose	/ik'spəuz/	v.(to)使暴露,受到;使曝光
exposure	/ik'spəuʒə/	n.暴露,揭露;方向;陈列;遗弃;照射量
express	/ik'spres/	v.表达,表示a.特快的,快速的n.快车,快运
expression	/ik'spreʃən/	n.表达;表情;声调;腔调;榨出;措词;式;符号
exquisite	/'ekskwizit/	a.优美的,高雅的,精致的;剧烈的,异常的
extend	/ik'stend/	v.延长,延伸;扩充;给予;提供;估价
extension	/ik'stenʃən/	n.延长;扩大;范围;大小;尺寸;电话分机
extensive	/ik'stensiv/	a.广大的,广阔的
extent	/ik'stent/	n.广度,宽度,长度;程度,限度
exterior	/ik'stiəriə/	a.外部的,外面的n.外部
external	/ik'stə:nəl/	a.外部的;客观的;外国的;表面的;/医/外用的
extinct	/ik'stiŋkt/	a.灭绝的;熄灭了的
extinguish	/ik'stiŋɡwiʃ/	v.熄灭;消灭;结束;压制;使黯然失色;偿清
extra	/'ekstrə/	a.额外的,附加的n.附加物,额外的东西
extract	/ik'strækt,'ekstrækt/	v./n.拔出,抽出;摘录n.抽取物;精华;选集
extraordinary	/ik'strɔ:dənəri/	a.非常的;格外的;意外的;离奇的;临时的
extravagant	/ik'strævəɡənt/	a.奢侈的;过分的;(言行等)放肆的
extreme	/ik'stri:m/	a.末端的,尽头的;极度的n.极端;最大程度
eye	/ai/	n.眼(睛);视力;眼力;监督vt.看,审视
eyebrow	/'aibrau/	n.眉毛
eyesight	/'aisait/	n.视力
fable	/'feibl/	n.寓言
fabric	/'fæbrik/	n.织物;织品;结构;构造;建筑物
fabricate	/'fæbrikeit/	v.捏造,编造(谎言,借口等);建造,制造
fabulous	/'fæbjuləs/	a.极好的;极为巨大的;寓言中的,传说中的
face	/feis/	n.脸,面貌;表情;正面v.面对着;朝,面向
facilitate	/fə'siliteit/	v.使变得(更)容易;使便利;推动;帮助;处进
facility	/fə'siliti/	n.灵巧,熟练;(pl.)设备,设施,便利条件
fact	/fækt/	n.事实,实际
factor	/'fæktə/	n.因素,要素
factory	/'fæktəri/	n.工厂
faculty	/'fækəlti/	n.才能;学院,系;(学院或系的)全体教学人员
fade	/feid,fad/	v.褪色;衰减,消失n.淡入(出)n.乏味(平淡)的
fail	/feil/	v.失败,不及格;衰退,减弱
failure	/'feiljə/	n.失败,不及格;失败者;故障,失灵;未能
faint	/'feint/	a.微弱的;不明显的;暗淡的n./v.昏倒;昏晕
fair	/fεə/	a.公平的,合理的;相当的n.集市,交易会
fairly	/'fεəli/	ad.公正地,正当地;相当,还算
fairy	/'fεəri/	a.幻想中的;虚构的;优雅的n.仙女;精灵
faith	/feiθ/	n.信任,信用;信仰,信条
faithful	/'feiθful/	a.守信的,忠实的,如实的,可靠的
fake	/feik/	n.假货,赝品a.假的,冒充的v.伪造;伪装
fall	/fɔ:l/	v.跌倒;下降;减弱;坠落;变成,陷于n.秋季
FALSE	/fɔ:ls/	a.谬误的,虚伪的,伪造的,假的
fame	/feim/	n.名声;名望;传说vt使出名;传扬…的名
familiar	/fə'miljə/	a.熟悉的;通晓的;亲近的n.熟客;密友
family	/'fæmili/	n.家,家庭成员;氏族,家庭;族,科
famine	/'fæmin/	n.饥荒,饥馑
famous	/'feiməs/	a.著名的
fan	/fæn/	n.扇子,风扇;(影,球等)迷v.扇,扇动,激起
fancy	/'fænsi/	n.爱好,迷恋v.想象,幻想a.花式的,奇特的
fantastic	/fæn'tæstik/	a.(fantastical)奇异的,幻想的,异想天开的
fantasy	/'fæntəsi/	n.幻想,空想;空想的产物,幻想作品
far	/fɑ:/	a./ad.远,久远,遥远ad.到…程度,…得多
fare	/fεə/	n.车费,船费;伙食;乘客v.过活;进展;经营
farewell	/'fεə'wel/	int.再会,别了n.告别
farm	/fɑ:m/	n.农场,饲养场v.种田,经营农牧业
farmer	/'fɑ:mə/	n.农民,农场主
farther	/'fɑ:ðə/	ad.更远地,再往前地a.更远的
fascinate	/'fæsineit/	v.迷住,强烈吸引
fashion	/'fæʃən/	n.流行式样(或货品),风尚,风气;样子,方式
fashionable	/'fæʃənəbl/	a.流行的,时髦的
fast	/fɑ:st,fæst/	a.快的,迅速的;坚固的ad.紧紧地;迅速地
fasten	/'fɑ:sən,'fæ-/	v.扎牢,使固定
fat	/fæt/	a.多脂肪的,肥胖的;丰厚的n.脂肪,肥肉
fatal	/'feitl/	a.致命的,毁灭性的
fate	/'feit/	n.命运
father	/'fɑ:ðə/	n.父亲;创始人,发明者;(Father)神父
fatigue	/fə'ti:ɡ/	n./v.(使)疲劳
fault	/fɔ:lt/	n.过失,过错;缺点,毛病
faulty	/'fɔ:lti/	a.有错误的,有缺点的,不完善的
favor	/'feivə/	n.(favour)好感;喜爱;关切v.赞成,支持,偏爱
favorable	/'feivərəbl/	a.(favourable)赞许的,有利的,讨人喜欢的
favorite	/'feivərit/	n.(favourite)最喜欢的人或物a.喜爱的
fax	/fæks/	n./v.传真(机)
fear	/fiə/	n.害怕,恐惧;危险vt.畏惧,害怕,担心
fearful	/'fiəful/	a.可怕的,吓人的;害怕,担心,惊恐
feasible	/'fi:zəbl/	a.可行的;切实可行的;行得通的;可用的
feast	/fi:st/	n.节日;宴会
feat	/fi:t/	n.功绩,伟业,技艺
feather	/'feðə/	n.羽毛
feature	/'fi:tʃə/	n.特征;容貌;特色;特写v.以...为特色
February	/ˈfebruəri/	n.二月
federal	/'fedərəl/	a.联邦的;联邦制的;联合的;同盟的
federation	/'fedəreiʃən/	n.同盟;联邦;联合;联盟;联合会
fee	/fi:/	n.费(会费,学费等);酬金
feeble	/'fi:bl/	a.虚弱的,无力的
feed	/fi:d/	v.(on,with)喂养,饲养;(with)向…供给
feedback	/'fi:dbæk/	n.反馈;反应;回授
feel	/'fi:l/	v.触;认为vi.摸上去有…感觉;摸索;觉得
feeling	/'fi:liŋ/	n.感情;心情;知觉;同情
fell	/fel/	v.击倒fel;打倒(疾病等);砍伐a.凶猛的;可怕的
fellow	/'feləu/	n.人,家伙;伙伴,同事a.同样的,同事的
fellowship	/'feləuʃip/	n.伙伴关系;联谊会,团体
female	/'fi:meil/	n.女性;女人;雌兽a.女性的;雌的;柔弱的
feminine	/'feminin/	a.女性的;娇柔的
fence	/'fens/	n.篱笆;围栏;剑术v.用篱笆瓦围住;击剑
ferry	/'feri/	n.摆渡;渡船;渡口v.摆渡;渡运(人,车或物等)
fertile	/'fə:tail/	a.肥沃的,富饶的;能繁殖的
fertilizer	/'fə:tilaizə/	n.(fertiliser)肥料
festival	/'festəvəl/	n.节日;音乐节;戏剧节a.节日的;快乐的
fetch	/fetʃ/	v.取来;接来;引出;售得;吸引n.取得;拿
feudal	/'fju:dl/	a.封建的;封地的;领地的
fever	/'fi:və/	n.发热,狂热
few	/fju:/	a./表肯定/有些,几个;/表否定/几乎没有的
fiber	/'faibə/	n.(fibre)纤维;构造;纤维制品
fiction	/'fikʃən/	n.虚构,编造;小说
field	/'fi:ld/	n.田野;运动场;(电或磁)场;领域,范围
fierce	/fiəs/	a.凶猛的,残忍的;狂热的,强烈的
fifteen	/'fifti:n/	num.十五pron./a.十五(个,只...)
fifty	/'fifti/	num.五十,五十个
fight	/fait/	v./n.打(仗),搏斗,斗争,战斗
figure	/'fiɡə/	n.体形;轮廓;数字;图形v.描绘;计算;推测
file	/'fail/	n.锉刀;文件,档案v.锉
fill	/fil/	v.(with)填满,充满
film	/film/	n.电影;胶片;薄膜,薄层vt.把..拍成电影
filter	/filtə/	n.滤器,滤纸
final	/'fainl/	a.最终的,决定性的n.结局;决赛;期末考试
finally	/'fainəli/	ad.最后,最终;决定性地
finance	/fai'næns/	n.财政,金融v.为…提供资金
financial	/fai'nænʃəl/	a.财政的,金融的
find	/faind/	v.(found,found)找到;发现;发觉;感到
finding	/'faindiŋ/	n.发现,发现物;(常pl.)调查/研究结果
fine	/fain/	a.晴朗的,美好的,细致的v./n.罚金,罚款
finger	/'fiŋɡə/	n.手指;指状物;指针
finish	/'finiʃ/	n.完成;结束;磨光v.完成;结束;用完;毁掉
finite	/'fainait/	a.有限的;/数/有穷的,限定的
fire	/'faiə/	n.火;火灾,失火;炉火vi.开火vt.放(枪)
fireman	/'faiəmən/	n.消防队员
fireplace	/'faiəpleis/	n.壁炉
firm	/'fə:m/	a.坚固的;坚决的,坚定的n.公司,商号
first	/fə:st/	a./ad.第一;最初;首次n.开始pron.第一名
fish	/fiʃ/	n.(pl.fish(es))鱼;鱼肉v.捕鱼;钓鱼
fisherman	/'fiʃəmən/	n.渔夫,捕鱼人
fist	/fist/	n.拳头vt.用拳头打;紧握
fit	/'fit/	a.(病的)发作,痉挛v./a.n.合适,试穿,安装
fitting	/'fitiŋ/	a.适当的,恰当的n.(常pl.)配件,附件;装配
five	/faiv/	num.五pron./a.五(个,只...)
fix	/fiks/	v.(使)固定;修理;安装;决定;注视n.困境
fixture	/'fikstʃə/	n.固定设备;预定日期;比赛时间;定期存款
flag	/flæɡ/	n.旗
flame	/fleim/	n.火焰,火苗;热情;光辉v.发火焰,燃烧
flap	/flæp/	n.垂下物,帽沿,袋盖n./v.拍打,拍动
flare	/flεə/	v./n.闪耀,闪烁
flash	/flæʃ/	n./a.闪光(的)v.发闪光,闪亮;闪现
flat	/flæt/	a.平坦的,扁平的,平淡的n.一套房间;平面
flatter	/'fleivə/	vt.奉承;使高兴;使满意;胜过
flavor	/'fleivə/	n.(flavour)情味;风味;滋味v.给…调味
flaw	/flɔ:/	n.裂缝;缺陷v.使破裂;使有缺陷
flee	/fli:/	v.逃走;逃避
fleet	/fli:t/	n.舰队,船队
flesh	/fleʃ/	n.肉,肌肉
flexible	/'fleksibl/	a.柔韧的,易弯曲的,灵活的,能变形的
flight	/flait/	n.飞翔,飞行;航班;航程;逃跑;楼梯的一段
fling	/fliŋ/	v.(用力地)扔,抛,丢
float	/fləut/	n.飘浮;漂流物v.浮动;漂浮;传播;动摇
flock	/flɔk/	n.(一)群,(禽,畜等的)群;大量v.群集,成群
flood	/flʌd/	n.洪水,水灾v.淹没,发大水,泛滥
floor	/flɔ:/	n.地板,(楼房)的层
flour	/'flauə/	n.面粉
flourish	/'flauriʃ/	n./v.繁荣,茂盛,兴旺
flow	/fləu/	v.流,流动n.流量,流速
flower	/'flauə/	n.花;精华,精粹,精英;盛时vi.开花
flu	/flu:/	n.(influenza)流行性感冒
fluctuate	/'flʌktjueit/	v.(使)波动;(使)起伏
fluent	/'flu(:)ənt/	a.流利的,流畅的
fluid	/'flu(:)id/	a.流动的,液体的n.流体,液体
flush	/flʌʃ/	n.脸红v.发红;奔流a.洋溢的;富裕的;齐平的
fly	/flai/	n.飞行;苍蝇v飞行;飘杨a.机敏的
foam	/fəum/	v./n.泡沫,起泡沫
focus	/'fəukəs/	n.焦点,(活动,兴趣等的)中心v.(on)使聚集
fog	/fɔɡ/	n.雾气,雾v.以雾笼罩,被雾笼罩
fold	/fəuld/	v.折叠;合拢;抱住n.褶,褶痕;羊栏;信徒
folk	/fəuk/	n.人们;民族;亲属a.民间的
follow	/'fɔləu/	v.跟随,接着;领会;沿着…前进,遵循;结果是
following	/'fɔləuiŋ/	a.下列的,下述的,其次的,接着的
fond	/fɔnd/	a.(of)喜爱的,爱好的
food	/fu:d/	n.食物,粮食,养料
fool	/fu:l/	n.傻子,笨蛋vt.欺骗,愚弄vi.干蠢事
foolish	/'fu:liʃ/	a.愚笨的,愚蠢的
foot	/fut/	n.(pl.feet)脚,足;英尺;底部
football	/'fut,bɔ:l/	n.足球
footstep	/'fut'step/	n.脚步(声),足迹
for	/强fɔ:,弱fə/	prep.为了;给;代替;向;支持conj.因为?
forbid	/fə'bid/	v.禁止,不许
force	/fɔ:s/	n.力量,力;势力;(pl.)(总称)军队v.强迫
fore	/fɔ:/	ad.在前面a.先前的;在前部的n.前部
forecast	/'fɔ:kɑ:st/	v./n.预测,预报
forehead	/'fɔrid/	n.前额;(任何事物的)前部
foreign	/'fɔrin/	a.外国的,(to)无关的;外来的;异质的
foreigner	/'fɔrinə/	n.外国人
foremost	/'fɔ:məust/	a.最先的;最初的;主要的ad.首要地
foresee	/fɔ:'si:/	v.预见,预知
forest	/'fɔrist/	n.森林
forever	/fə'revə/	adv.(forever)永远;总是
forge	/fɔ:dʒ/	v.锻造,伪造n.锻工车间;锻炉
forget	/fə'ɡet/	v.忘记,遗忘
forgive	/fə'ɡiv/	v.原谅,饶恕
fork	/fɔ:k/	n.叉,耙;叉形物;餐叉
form	/fɔ:m/	n.形状,形式;表格v.组成,构成;形成
formal	/'fɔ:məl/	a.正式的;形式的
format	/'fɔ:mæt/	n.(出版物的)开本,版式,格式vt.设计;安排
formation	/'fɔ:mə/	n.形成;构成;组织;构造;编制;塑造
former	/'fɔ:mə/	a.以前的,在前的pron.前者
formidable	/'fɔ:midəbl/	a.强大的;令人敬畏的;可怕的;艰难的
formula	/'fɔ:mjulə/	n.(pl.formulae)公式;规则;分子式;药方
formulate	/'fɔ:mjuleit/	v.用公式表示;规划;设计;系统地阐述
forth	/fɔ:θ/	ad.向前;向外,往外
forthcoming	/'fɔ:θ'kʌmiŋ/	a.即将到来的;准备好的;乐意帮助的;n.来临
fortnight	/'fɔ:tnait/	n.两星期
fortunate	/'fɔ:tʃənit/	a.幸运的,侥幸的
fortune	/'fɔ:tʃən,-tʃu:n/	n.运气;命运;财产;财富
forty	/'fɔ:ti/	num./a.四十pron.四十(个,只...)
forum	/'fɔ:rəm/	n.论坛,讨论会
forward	/'fɔ:wəd/	ad.(alsoforwards)向前a.向前的v.转交
fossil	/'fɔsəl/	n.化石
foster	/'fɔstə/	vt.养育;收养;怀抱;鼓励a.收养的n.养育者
foul	/faul/	a.污秽的;邪恶的v.弄脏;妨害;犯规n.犯规
found	/faʊnd/	vt.建立;创立;创办;使有根据;铸造;熔制
foundation	/faun'deiʃən/	n.基础,根本,建立,创立;地基,基金,基金会
fountain	/'fauntin/	n.泉水,喷泉,源泉
four	/fɔ:/	num.四pron./a.四(个,只...)
fourteen	/'fɔ:'ti:n/	num.十四,十四个
fox	/fɔks/	n.狐狸
fraction	/'frækʃən/	n.碎片,小部分,一点儿;分数
fracture	/'fræktʃə/	n.裂缝(痕);骨折v.(使)断裂,(使)折断
fragile	/'frædʒail/	a.易碎的,脆的,易损坏的;虚弱的,脆弱的
fragment	/'fræɡmənt/	n.碎片,小部分,片断
fragrant	/'freiɡrənt/	a.香的;芬芳的
frame	/freim/	n.框架;体格;骨架;组织;机构v.设计;制定
framework	/'freimwə:k/	n.构架;框架;结构;组织;机构
frank	/fræŋk/	a.坦白的,直率的
fraud	/frɔ:d/	n.欺诈,诈骗;欺骗(行为);骗子;假货
free	/fri:/	a.自由的;免费的;免税的;空闲的vt.释放
freedom	/'fri:dəm/	n.自由,自主,免除,特权
freeze	/fri:z/	v.使结冰,使凝固
freight	/freit/	n.货物,货运,运费
frequency	/'frikwənsi/	n.频率,周率
frequent	/'fri:kwənt,fri'kwent/	a.时常发生的,频繁的
fresh	/freʃ/	a.新鲜的,无经验的
friction	/'frikʃən/	n.磨擦,摩擦力
Friday	/ˈfraɪdeɪ,ˈfraɪdi/	n.星期五
fridge	/fridʒ/	n.(refrigerator的略语)冰箱
friend	/frend/	n.朋友
friendly	/'frendli/	a.友好的,友谊的
friendship	/ˈfrendʃɪp/	n.友谊,友好
fright	/frait/	n.恐怖
frighten	/'fraitən/	v.使惊恐
fringe	/frindʒ/	n.边缘;(窗帘)缘饰;额前垂发vt.饰…的边
frog	/frɔɡ/	n.蛙
from	/强frɔm,弱frəm/	prep.从,自从;由于;离;根据,按;去除
front	/frʌnt/	a.前面的,前部的n.正面;前线,战线v.面对
frontier	/'frʌntjə/	n.国境,边境;尖端,新领域
frost	/frɔst/	n.霜,霜冻,严寒
frown	/fraun/	v.皱眉
fruit	/fru:t/	n.水果,果实;成果,效果
fruitful	/'fru:tful/	a.多产的;果实累累的,富有成效的
frustrate	/frʌs'treit/	vt.挫败,阻挠,使灰心
fry	/frai/	v.油煎,油炸
fuel	/'fjuəl/	n.燃料vt.给…加燃料
fulfill	/ful'fil/	v.(fulfil)完成,履行,实践,满足
full	/ful/	a.(of)满的,充满的a./ad.完全,充分
fume	/fju:m/	n.(浓烈或难闻的）烟,气,汽
fun	/fʌn/	n.玩笑,娱乐;有趣的人(或事物)
function	/'fʌŋkʃən/	n.功能,作用;(pl.)职务;函数v.起作用
fund	/fʌnd/	n.资金,基金;存款,现款;(知识等的)累积
fundamental	/,fʌndə'mentəl/	a.基础的,基本的n.(pl.)基本原则,基本原理
funeral	/'fju:nərəl/	n.丧葬,葬礼
funny	/'fʌni/	a.滑稽的,可笑的
fur	/fə/	n.毛,毛皮
furious	/'fju:riəs/	a.狂怒的,狂暴的,猛烈的
furnace	/'fə:nis/	n.炉子,熔炉
furnish	/'fə:niʃ/	v.供应,提供;装备,布置
furniture	/'fə:nitʃə/	n.家具
further	/'fə:ðə/	ad./a.更远,更往前;进一步v.促进,增进
furthermore	/'fə:ðəmɔ:/	ad.而且,此外
fuse	/fju:z/	n.保险丝,导火线,引信v.熔化,熔合
fuss	/fʌs/	n./v.忙乱,大惊小怪
futile	/'fju:tail/	a.无效的,无用的,无希望的
future	/'fju:tʃə/	n.将来,未来;前途,前景a.将来的,未来的
gain	/ɡein/	v.获得;增加;表等走快n.增进,增加;收益
galaxy	/'ɡæləksi/	n.星系;(theGalaxy)银河(系);一群显赫的人
gallery	/'ɡæləri/	n.长廊,画廊,美术馆
gallon	/'ɡælən/	n.加仑
gallop	/'ɡæləp/	v./n.奔驰,飞奔
gamble	/'ɡæmbl/	n./v.投机,冒险;赌博
game	/ɡeim/	n.游戏,娱乐;比赛;(pl.)运动会vi.赌博
gang	/ɡæŋ/	n.一帮,一群,一伙
gaol	/dʒeil/	n.(jail)监狱;(不加冠词)监禁vt.使…坐牢
gap	/ɡæp/	n.缺口;差距;空白;缺乏
garage	/'ɡærɑ:dʒ,ɡə'r-/	n.车库,飞机库;修车厂
garbage	/'ɡɑ:bidʒ/	n.垃圾
garden	/'ɡɑ:dn/	n.(菜,花)园;公园
garlic	/'ɡɑ:lik/	n.蒜,大蒜粉
garment	/'ɡɑ:mənt/	n.(一件)衣服
gas	/ɡæs/	n.气体;煤气;汽油;毒气vt.毒(死);加油
gasoline	/'ɡæsəli:n/	n.(gasolene)汽油
gasp	/ɡɑ:sp,ɡæsp/	n.喘息,气喘v.喘息;气吁吁地说
gate	/ɡeit/	n.大门;入口;观众人数,门票收入
gather	/'ɡæðə/	v.聚集,聚拢;推测,推断
gauge	/ɡeidʒ/	n.标准尺寸;规格;量规,量表v.测量
gay	/ɡei/	a.快乐的,愉快的,色彩鲜艳的n.同性恋
gaze	/ɡeiz/	v./n.凝视,注视
gear	/ɡiə/	n.齿轮,传动装置v.(to)调整,使适合
gender	/'dʒendə/	n.(生理上的)性;(名词、代词等的)性
gene	/dʒi:n/	n.基因
general	/'dʒenərəl/	a.一般的,普通的;总的,大体的n.将军
generalize	/'dʒenərəlaiz/	v.(generalise)归纳,概括;推广,普及
generate	/'dʒenəreit/	vt.产生,发生;生殖
generation	/,dʒenə'reiʃən/	n.产生,发生;一代(人)
generator	/'dʒenəreitə/	n.发电机,发生器
generous	/'dʒenərəs/	a.宽宏大量的,慷慨的
genetic	/dʒi'netik/	a.遗传(学)的n./-s/遗传学
genius	/'dʒi:njəs/	n.天才
gentle	/'dʒentl/	a.和蔼的,文雅的,有礼貌的
gentleman	/'dʒentlmən/	n.绅士,先生
gently	/'dʒentli/	ad.文雅地,有礼貌地;轻轻地
genuine	/'dʒenjuin/	a.真正的,名副其实的
geography	/dʒi'ɔɡrəfi/	n.地理(学)
geology	/dʒi'ɔlədʒi/	n.地质(学)
geometry	/dʒi'ɔmitri/	n.几何(学)
germ	/dʒə:m/	n.微生物,细菌
gesture	/'dʒestʃə/	n.姿势,姿态,手势v.做手势
get	/ɡet/	v.获得,得到;使,使得;变得,成为;到达
ghost	/ɡəust/	n.鬼魂,幽灵
giant	/'dʒaiənt/	n.巨人a.巨大的
gift	/ɡift/	n.礼品,赠品;天赋,才能
gigantic	/,dʒai'ɡæntik/	a.巨大的,庞大的
giggle	/'ɡiɡl/	vi.／n.痴笑;咯咯地笑vt.咯咯地笑着说
girl	/ɡə:l/	n.少女,姑娘,女孩;女职员
give	/ɡiv/	v.给,授予;供给;献出,让步;捐赠;发表
glad	/ɡlæd/	a.高兴的,快活的;乐意的,情愿的
glamor	/'ɡlæmə/	n.(glamour)魅力;魔法vt.迷惑
glance	/ɡlɑ:ns,ɡlæns/	v.(at,over)扫视n.匆匆看,一瞥,一眼
glare	/ɡlεə/	vi.怒目而视;发射强光n.强光;怒视;炫耀
glass	/ɡlɑ:s,ɡlæs/	n.玻璃;玻璃杯;镜子;(pl.)眼镜
glide	/ɡlaid/	n./v.溜,滑行;(时间)消逝
glimpse	/ɡlimps/	n./v.一瞥,瞥见
glitter	/'ɡlitə/	n.光辉,灿烂v.闪闪发光;闪耀
global	/'ɡləubəl/	a.球形的;全球的,全世界的;全面的
globe	/ɡləub/	n.球体,地球仪;地球,世界
gloomy	/'ɡlu:mi/	a.阴暗的,阴沉的,令人沮丧的,阴郁的
glorious	/'ɡlɔ:riəs/	a.壮丽的,辉煌的;光荣的
glory	/'ɡlɔ:ri/	n.光荣,荣誉
glove	/ɡlʌv/	n.手套
glow	/ɡləu/	v.发热,发光,发红n.白热
glue	/ɡlu:/	n.胶,胶水v.胶合,粘贴
go	/ɡəu/	v.去,离开;走;放置;变成;运转n.围棋
goal	/ɡəul/	n.目的,目标;守门员,球门;进球
goat	/ɡəut/	n.山羊
god	/ɡɔd/	n.上帝(小写god泛指所有的“神,神像”)
gold	/ɡəuld/	n.金,黄金;金币;金黄色a.金的,金制的
golden	/'ɡəuldən/	a.金黄色的;贵重的,极好的
golf	/ɡɔlf/	n.高尔夫球
good	/ɡud/	a.好的;善良的;擅长的;乖的n.好处;利益
goodby	/,ɡud'bai/	int.(goodbye)再见
goodness	/'ɡudnis/	n.善良,仁慈;(食物等)精华int.天哪
goods	/ɡudz/	n.(pl.)货物,商品
goose	/ɡu:s/	n.(pl.geese)鹅,雌鹅,鹅肉
gorgeous	/'ɡɔ:dʒəs/	a.华丽的;灿烂的;美丽的;宜人的;棒的
gossip	/'ɡɔsip/	n./v.(说)闲话,闲聊
govern	/'ɡʌvən/	v.统治,管理;决定,支配
government	/'ɡʌvənmənt/	n.政府,内阁;管理,支配;政治,政体
governor	/'ɡʌvənə/	n.统治者,管理者,总督,州(省)长
gown	/ɡaun/	n.长袍,特殊场合穿的长服
grab	/ɡræb/	v./n.(at)抓(住);夺(得)
grace	/ɡreis/	n.优美,文雅;恩惠,恩泽;宽限,缓刑;感恩祷告
graceful	/'ɡreisful/	a.优美的,文雅的,大方的
gracious	/'ɡreiʃəs/	a.亲切的,客气的;宽厚的,仁慈的
grade	/ɡreid/	n.等级,级别;年级;分数v.分等,分级
gradual	/'ɡrædʒuəl/	a.逐渐的,逐步的
graduate	/'ɡrædjueit,-dʒu-/	n.大学毕业生,研究生v.大学毕业a.毕了业的
grain	/ɡrein/	n.谷物,谷类;颗粒,细粒
gramme	/ɡræm/	n.(gram)克
grammar	/'ɡræmə/	n.语法,语法书
grand	/ɡrænd/	a.盛大的,豪华的;重大的,主要的
grandmother	/'ɡrænd,mʌðə/	n.祖母,外祖母
grant	/ɡrɑ:nt,ɡrænt/	v.同意,准予;授予n.授予物;津贴;转让证书
grape	/ɡreip/	n.葡萄
graph	/ɡrɑ:f,ɡræf/	n.图表,曲线图
graphic	/'ɡræfik/	a.绘画似的,图解的,生动的
grasp	/ɡrɑ:sp,ɡræsp/	v./n.抓住,抓紧;掌握,领会
grass	/ɡrɑ:s,ɡræs/	n.草,草地
grateful	/'ɡreitful/	a.(to,for)感激的;感谢的
gratitude	/'ɡrætitju:d/	n.感激,感谢
grave	/ɡreiv/	n.坟墓a.严肃的,庄重的
gravity	/'ɡræviti/	n.重力,引力;严肃,庄重
graze	/ɡreiz/	vi.吃青草vt.放牧;擦伤;掠过.n.擦伤(处)
grease	/ɡri:s/	n.动物脂,油脂,润滑脂v.抹油,润滑
great	/ɡreit/	a.伟大的;重要的;大量的;很好的;美好的
greedy	/ɡri:di/	a.贪吃的,贪婪的,渴望的
green	/ɡri:n/	a.绿色的;生的;未成熟的n.绿色;蔬菜;植物
greenhouse	/'ɡri:nhaus/	n.温室
greet	/ɡri:t/	v.致敬,敬意,迎接;扑(鼻),入(耳),触(目)
greeting	/'ɡri:tiŋ/	n.问候,致敬
grey	/ɡrei/	n./a.(gray)灰色(的)
grief	/ɡri:f/	n.悲伤,悲痛;悲伤的事,悲痛的缘由
grieve	/ɡri:v/	v.使悲伤,使伤心
grim	/ɡrim/	a.严酷的,令人害怕的;不愉快的,讨厌的
grin	/ɡrin/	n./vi.露齿而笑,咧嘴一笑
grind	/ɡraind/	v.磨(碎),碾(碎)
grip	/ɡrip/	v./n.紧握,抓紧;掌握
groan	/ɡrəun/	v./n.呻吟
grocer	/'ɡrəusə/	n.食品商,杂货商
grope	/ɡrəup/	n./v.摸索,探索
gross	/ɡrəus/	a.总的,毛(重)的;粗鲁的,粗俗的n.总额
ground	/ɡraund/	n.地,地面,土地;场地,场所;理由,根据
group	/ɡru:p/	n.群,组v.分组
grow	/ɡrəu/	v.生长,成长;渐渐变成;栽培,种植;发展
grown-up	/ˌɡrəʊn ˈʌp , ˈɡrəʊn ʌp/	a.成长的,成熟的,成人的n.成年人
growth	/ɡrəuθ/	n.生长,增长,发展
guarantee	/,ɡærən'ti:/	n.保证,保证书v.保证,担保
guard	/ɡɑ:d/	v./n.保卫,守卫,提防n.哨兵,警卫,看守
guess	/ɡes/	v./n.猜测,推测;以为;猜想/同/surmise
guest	/ɡest/	n.客人,宾客,旅客
guidance	/'ɡaidəns/	n.引导,指导
guide	/ɡaid/	n.领路人;指南,导游v.领路;指导;支配;管理
guideline	/'ɡaidlain/	n.指导方针,指导原则,准则,标准
guilt	/ɡilt/	n.罪过,内疚
guilty	/'ɡilti/	a.(of)有罪的,内疚的
guitar	/ɡi'tɑ:/	n.吉他vi.弹吉他
gulf	/ɡʌlf/	n.海湾
gum	/ɡʌm/	n.树胶;口香糖
gun	/ɡʌn/	n.枪,炮,手枪
gut	/ɡʌt/	n./pl./胆量;内脏a.本能的vt.取出内脏
guy	/ɡai/	n.家伙,人
gymnasium	/dʒim'neiziəm/	n.(gym)体育馆,健身房
habit	/'hæbit/	n.习惯,习性,脾性
habitat	/'hæbitæt/	n.(动物的)栖息地,(植物的)产地
hail	/heil/	v.下雹;欢呼,欢迎n.雹
hair	/hεə/	n.毛发,头发;绒毛,毛状物
half	/hɑ:f,hæf/	n.半,一半a.一半的,不完全的ad.一半地
hall	/hɔ:l/	n.礼堂,会堂,办公大楼,门厅
halt	/hɔ:lt/	n.止步,停步,停止前进v.止步,(使)停止
ham	/hæm/	n.火腿
hamburger	/'hæmbə:ɡə/	n.汉堡包,牛肉饼
hammer	/'hæmə/	n.铁锤,槌,榔头v.锤击,敲打
hamper	/'hæmpə/	v.妨碍,阻碍,牵制
hand	/hænd/	n.手,人手,雇员;专门业人员;指针v.交
handbook	/'hændbuk/	n.手册,指南
handful	/'hændful/	n.一把;少数;一小撮
handicap	/'hændikæp/	v.妨碍n.(身体或智力方面的)缺陷;不利条件
handkerchief	/'hæŋkətʃif,-tʃi:f/	n.手帕
handle	/'hændl/	n.柄,把手,拉手v.处理,对待,操纵;触,抚养
handsome	/'hænsəm/	a.漂亮的,英俊的;慷慨的,数量可观的
handwriting	/'hænd,raitiŋ/	n.笔迹,手迹,书法
handy	/'hændi/	a.手边的,近便的;方便的
hang	/'hæŋ/	v.悬挂,垂吊;吊死,绞死
happen	/'hæpən/	v.(偶然)发生;碰巧,恰好
happy	/'hæpi/	a.快乐的,幸福的;乐意的;令人满意的
harassment	/'hærəsmənt/	n.骚扰,扰乱;烦恼,烦乱
harbor	/'hɑ:bə/	n.(harbour)海港;避难所v.隐匿,窝藏
hard	/hɑ:d/	a.坚硬的;结实的;困难的;难忍的;严厉的
harden	/'hɑ:dən/	v.(使)变硬
hardly	/'hɑ:dli/	ad.几乎不,简直不;仅仅
hardship	/'hɑ:dʃip/	n.艰难,困苦
hardware	/'hɑ:dwεə/	n.五金,金属制品;硬件
harm	/hɑ:m/	n./v.伤害,损害,危害
harmony	/'hɑ:məni/	n.协调,和谐;融洽
harness	/'hɑ:nis/	v.治理,利用n.马具,挽具
harsh	/hɑ:ʃ/	a.粗糙的;(声音)刺耳的;苛刻的,严酷的
harvest	/'hɑ:vist/	n.收获,收成;成果,后果v.收获,收割
haste	/heist/	n.匆忙,急速;草率v.赶快;匆忙
hasty	/'heisti/	a.匆忙的,仓促的;草率的
hat	/hæt/	n.帽子(一般指有边的帽子)
hatch	/hætʃ/	v.孵,孵出;策划,图谋n.舱口,小门
hate	/heit/	v.恨,憎恨;不愿,不喜欢n.恨,憎恶
hatred	/'heitrid/	n.憎恨,憎恶,怨恨
haul	/hɔ:l/	v.拖曳,拖运,用力拖
have	/hæv,弱həv,əv,v/	v.有,具有;体会,经受;从事;使;吃,喝
hawk	/hɔ:k/	n.鹰,隼
hay	/hei/	n.干草
hazard	/'hæzəd/	n.危险,冒险,危害v.冒险,拼命
he	/hi:,弱hi,i:,i/	pron.他;(不论性别的)一个人
head	/hed/	n.头;顶部;领导,首脑v.主管;位于..顶部
headache	/'hedeik/	n.头痛
heading	/'hediŋ/	n.标题
headline	/'hedlain/	n.大字标题,新闻标题
headmaster	/'hed'mɑ:stə/	n.校长
headquarters	/,hed'kwɔ:təz/	n.司令部,指挥部;总部,总局
heal	/hi:l/	v.治愈,愈合
health	/helθ/	n.健康,健康状况;卫生
healthy	/'helθi/	a.健康的,健壮的;有益健康的,卫生的
heap	/hi:p/	n.(一)堆,大量,许多v.(up)堆,堆起
hear	/hiə/	v.听见;审讯;(from)收到..的信/电话;听说
hearing	/'hiəriŋ/	n.听,倾听;听力;审讯
heart	/hɑ:t/	n.心(脏);内心,感情;热忱;中心,要点
heat	/hi:t/	n.热,热度;热烈,激烈v.(给)加热,(使)变热
heave	/hi:v/	v.(用力)举,提,拉;扔;拖;呕吐n.举起
heaven	/'hevən/	n.天,天空,天堂;(Heaven)上帝,神
heavy	/'hevi/	a.重的,重型的;沉重的,大量的,猛烈的
hedge	/hedʒ/	n.篱笆,树篱,障碍物v.用树篱围住
heel	/hi:l/	n.脚后跟,踵,鞋跟
height	/hait/	n.高,高度;(常pl.)高地,高处
heighten	/'haitən/	v.提高,升高
heir	/εə/	n.继承人
helicopter	/'helikɔptə/	n.直升(飞)机
hell	/hel/	n.地狱,阴间;苦境,极大痛苦
hello	/he'ləu,hə-/	int.英(美)喂,你好(用来打招呼或引起注意)
helmet	/'helmit/	n.头盔,钢盔
help	/help/	v.帮(援)助;有助于;/呼救/救命n.帮助(手)
helpful	/'helpful/	a.(to)有帮助的,有益的,有用的
hemisphere	/'hemi,sfiə/	n.半球
hen	/hen/	n.母鸡
hence	/hens/	ad.从此,今后;因此
henceforth	/'hens'fɔ:θ/	ad.今后
her	/hə:,弱ə:,hə,ə/	pron./she的宾格/她;/she的所有格/她的
herb	/hə:b,ə:b/	n.药草,(调味用的)香草,草本植物
herd	/hə:d/	n.群,兽群,牛群v.放牧,群集
here	/hiə/	ad.在(到,向)这里;这时;在这一点上
heritage	/'heritidʒ/	n.遗产,继承物;传统
hero	/'hiərəu/	n.英雄,勇士;男主角,男主人公
heroic	/hi'rəuik/	a.英雄的,英勇的,崇高的
heroin	/'herəuin/	n.海洛因
heroine	/'herəuin/	n.女英雄;女主角
hers	/hə:z/	pron./she的物主代词/她的(所有物)
herself	/hə:'self/	pron./反身代词/她自己;她亲自,她本人
hesitate	/'heziteit/	v.犹豫,踌躇;含糊,支吾
hi	/hai/	interj.(hey)嗨!喂!
hide	/haid/	v.隐藏,躲藏;隐瞒n.皮革,兽皮
hierarchy	/'haiə,rɑ:ki/	n.等级制度;统治集团,领导层
high	/hai/	a.高的,高度的,高级的,高尚的ad.高高地
highland	/'hailənd/	n.高地,高原
highlight	/'hailait/	v.使显著,使突出;强调n.最精彩的部分
highly	/'haili/	ad.高度地,很,非常;赞许地
highway	/'haiwei/	n.公路,大路
hijack	/'haidʒæk/	v.劫持,劫机,拦路抢劫
hike	/haik/	n.徒步旅行;增加vi.徒步旅行vt.提高
hill	/hil/	n.小山,山岗,高地;/pl./丘陵(地带)
him	/him,弱im/	pron.他(he的宾格形式)
himself	/him'self/	pron./反身代词/他自己;他本人
hinder	/ˈhɪndər/	v.(from)阻止,妨碍a.后面的
hinge	/hindʒ/	n.合页,铰链vi.依…而定
hint	/hint/	n.暗示,提示,线索v.暗示,示意
hip	/hip/	n.臀部,髋;屋脊
hire	/haiə/	n./v.雇用,租借
his	/hiz,弱iz/	pron./he的所有格/物主代词/他的(所有物)
historian	/his'tɔ:riən/	n.历史学家
historic	/his'tɔrik/	a.有历史意义的;历史的
historical	/his'tɔrikəl/	a.历史的;有关历史的
history	/'histəri/	n.历史,历史学;来历,经历
hit	/hit/	v.打,击;碰撞n.击中;成功而风行一时的事物
hitherto	/,hiðə'tu:/	ad.到目前为止,迄今
hobby	/'hɔbi/	n.业余爱好,嗜好,兴趣
hoist	/hɔist/	v.举起,升起,吊起
hold	/həuld/	v.拿着;保有;托住;举行;继续n.握住;船舱
holder	/'həuldə/	n.持有者,占有者;(台,架等)支持物
hole	/həul/	n.洞,孔
holiday	/'hɔlədi/	n.假日,节日,假期,休假
hollow	/'hɔləu/	a.空的,中空的;空洞的,空虚的v.挖空,凿空
holy	/'həuli/	a.神圣的,圣洁的
home	/həum/	ad.回家,在家n.家;家乡a.家庭的;家乡的
homework	/'həumwə:k/	n.(学生的)家庭作业、课外人员
homogeneous	/,hɔmə'dʒi:niəs/	a.同种类的,同性质的,有相同特征的
honest	/'ɔnist/	a.诚实的,正直的,老实的
honey	/'hʌni/	n.蜜,蜂蜜
honor	/'ɔnə/	n.(honour)尊敬,敬意;荣誉,光荣v.尊敬
honorable	/'ɔnərəbl/	a.(honourable)可敬的;荣誉的,光荣的
hook	/huk/	n.钩,吊钩,钩状物v.钩住
hop	/hɔp/	v.人单足跳;跳上(车等)n.蹦跳;短程飞行
hope	/həup/	n.希望,期望;希望的人或事v.希望,期望
hopeful	/'həupful/	a.给人希望的,抱有希望的
horizon	/hə'raizən/	n.地平线;眼界,见识
horizontal	/'hɔri'zɔntəl/	a.地平线的;水平的
horn	/hɔ:n/	n.(牛羊等的)角;号,喇叭;角状物;角制品
horrible	/'hɔrəbl/	a.令人恐惧的,可怕的;极讨厌的,糟透的
horror	/'hɔrə/	n.恐怖,战栗
horse	/hɔ:s/	n.马;跳马,鞍马v.骑马
horsepower	/'hɔ:s,pauə/	n./机/马力
hose	/həuz/	n.水龙带,软管v.用软管(淋浇,冲洗)
hospital	/'hɔspitəl/	n.医院
hospitality	/,hɔspi'tæləti/	n.好客,殷勤,款待
host	/həust/	n.主人;旅店老板;节目主持人;一大群,许多
hostage	/'hɔstidʒ/	n.人质
hostess	/'həustis/	n.女主人,女主持人
hostile	/'hɔstail,-təl/	a.敌对的,敌方的,敌意的
hot	/hɔt/	a.(炎)热的;辣的;急躁的;激动的;热衷的
hotel	/həu'tel/	n.旅馆
hound	/haund/	n.猎狗;卑鄙的人vt.用猎狗追,追逐
hour	/'auə/	n.小时,钟点;时刻;课时,工作时间
house	/haus,hauz/	n.房屋;商业机构;/H-/议院v.给...房子住
household	/'haushəuld/	n.家庭,家人a.家庭(务)的,家常的
housewife	/'hauswaif/	n.家庭主妇
housework	/'hauswə:k/	n.家务,家事(不可数)
housing	/ˈhaʊzɪŋ/	n.住房,住房供给;(外、阀)壳,防护罩
hover	/'hɔvə,'hʌ-/	vi.(鸟)盘旋,翱翔,(人)逗留在附近徘徊
how	/hau/	ad..(表示方法、手段、状态)怎样;如何
however	/hau'evə/	ad.然而,可是,不过,无论如何conj.无论
howl	/haul/	n.怒吼,嗥叫vi.(风等)怒吼,咆哮
huddle	/'hʌdl/	n./v.拥挤;聚集v.(因寒冷、害怕而)缩成一团
hug	/hʌɡ/	v./n.热烈拥抱,紧抱
huge	/hju:dʒ/	a.巨大的,庞大的
hum	/hʌm/	v.哼曲子;发嗡嗡声;忙碌n.嗡嗡声,嘈杂声
human	/'hju:mən/	a.人的,人类的n.人
humanity	/hju:'mænəti/	n.人类,人性,人情;(pl.)人文科学
humble	/ˈhʌmbl/	a.谦卑的,恭顺的;地位低下的v.降低,贬低
humid	/'hju:mid/	a.湿的,湿气重的
humidity	/hju:'midəti/	n.湿气,湿度
humiliate	/hju:'milieit/	v.使羞辱,使丢脸/同/disgrace
humor	/'hju:mə/	n.(humour)幽默,诙谐
humorous	/'hju:mərəs/	a.富于幽默感的,幽默的;滑稽的
hundred	/'hʌndrəd/	num.百,一百;/pl./许多a.一百的;许多
hunger	/'hʌŋɡə/	n./v.饥饿;渴望
hungry	/'hʌŋɡri/	a.饥饿的,渴望的
hunt	/hʌnt/	v./n.打猎,猎取;(for)搜索;寻找
hurl	/hə:l/	vt.猛投,力掷;大声叫骂
hurricane	/'hʌrikən/	n.飓风
hurry	/'hʌri,'hə:ri/	vi.匆忙vt.催促;急运(派)n.急(匆)忙
hurt	/hə:t/	n.伤痛,伤害v.刺痛,伤害;伤…的感情
husband	/'hʌzbənd/	n.丈夫
hut	/hʌt/	n.小屋,棚屋
hydrogen	/'haidrədʒən/	n.氢
hypocrisy	/hi'pɔkrisi/	n.伪善,虚伪
hypothesis	/hai'pɔθisis/	n.假说,假设,前提
hysterical	/hɪˈsterɪkl/	a.情绪异常激动的,歇斯底里的
I	/aɪ/	pron.(主格)我
ice	/ais/	n.冰;冰冻甜食vt.冰冻,使成冰
ice-cream	/'aiskri:m/	n.冰淇淋
idea	/ai'diə,'ai'diə/	n.想法,念头;概念,观念;意见,主意
ideal	/ai'diəl/	a.理想的;空想的;理想主义的;唯心的n.理想
identical	/ai'dentikəl/	a.(to.with)同一的,同样的
identification	/ai,dentifi'keiʃən/	n.识别,鉴别;证件;认同
identify	/ai'dentifai/	v.识别,鉴别;(with)把…和…看成一样
identity	/ai'dentəti/	n.身份;本体;特征;同一(性);一致;国籍;等式
ideology	/,aidi'ɔlədʒi,,idi-/	n.意识形态,(政治或社会的)思想意识
idiom	/'idiəm/	n.习语;成语方言;(艺术等的)风格,特色
idiot	/'idiət/	n.白痴;极蠢的人;笨蛋
idle	/'aidl/	a.空闲的,闲置的;懒散的v.空费,虚度
if	/ɪf/	conj.(用于连接宾语从句)是否;是不是
ignite	/iɡ'nait/	v.点火,引燃
ignorance	/'iɡnərəns/	n.无知,愚昧;不知道
ignorant	/'iɡnərənt/	a.无知的,愚昧的;不知道的
ignore	/iɡ'nɔ:/	v.不理,不顾,忽视
ill	/il/	a.有病的;坏的;恶意的ad.坏地;不利地
illegal	/ɪˈliːɡl/	a.不合法的,非法的
illiterate	/i'litərət/	a.文盲的,未受教育的
illness	/'ilnis/	n.病,疾病
illuminate	/i'lju:mineit/	vt.照亮,照明;用灯光装饰;说明,阐释
illusion	/i'lju:ʒən/	n.幻想,错误的观念;错觉,幻觉,假象
illustrate	/'iləstreit/	v.举例说明,阐明;图解,加插图
illustration	/,ilə'streiʃən/	n.说明;例证,插图;举例说明
image	/'imidʒ/	n.形象,声誉;印象;像;形象的描述,比喻
imaginary	/i'mædʒinəri/	a.想象的,虚构的
imagination	/i,mædʒi'neiʃən/	n.想象(力);空想,幻觉;想象出来的事物
imaginative	/i'mædʒinətiv/	a.富有想象力的,爱想象的
imagine	/i'mædʒin/	v.想象,设想,料想
imitate	/'imiteit/	v.模仿,仿效;仿造,伪造
imitation	/,imi'teiʃən/	n.模仿,仿效;仿制;仿造品
immediate	/i'mi:diət/	a.立即的,即时的;直接的,最接近的
immense	/i'mens/	a.广大的,巨大的;/口/极好的
immerse	/i'mə:s/	v.使沉浸在;使浸没
immigrant	/'imiɡrənt/	a.(从国外)移来的,移民的n.移民,侨民
immune	/i'mju:n/	a.免疫的,有免疫力的;不受影响的;豁免的
impact	/'impækt,im'pækt/	n.冲击,碰撞;影响v.影响;挤入,压紧
impair	/im'pεə/	v.损害,损伤;削弱,减少
impart	/im'pɑ:t/	vt.传授,给予;告知,通知
impatient	/im'peiʃənt/	a.不耐烦的,急躁的
imperative	/im'perətiv/	n.命令;需要;规则;祈使语气a.强制的;紧急的
imperial	/im'piəriəl/	a.帝国的,帝王的;(度量衡)英制的
impetus	/ˈɪmpɪtəs/	n.推动(力),促进
implement	/'impliment/	n.(pl.)工具,器具v.贯彻,实现
implication	/,impli'keiʃən/	n.含意,暗示,暗指;牵连
implicit	/im'plisit/	a.含蓄的;(in)固有的;无疑问的;绝对的
imply	/im'plai/	v.意指,含…意思,暗示
import	/im'pɔ:t,'impɔ:t/	v./n.进口,输入,(pl.)进口商品;要旨,含意
importance	/im'pɔ:təns/	n.重要,重要性
important	/im'pɔ:tənt/	a.重要的,重大的;有地位的,有权力的
impose	/im'pəuz/	v.征(税);(on)把…强加给
impossible	/im'pɔsəbl/	a.不可能的;难以忍受的,很难对付的
impress	/im'pres,'impres/	v.(on)印,盖印;留下印象,引人注目
impression	/im'preʃən/	n.印象,感想;盖印,压痕
impressive	/im'presiv/	a.给人深刻印象的,感人的
improve	/im'pru:v/	v.改善,改进,增进;好转,进步
improvement	/im'pru:vmənt/	n.改进,进步,增进;改进措施
impulse	/'impʌls/	v.推动n.推动;冲动,刺激
in	/in/	prep.在…里(内,上);用…(表示)ad.进,入
incentive	/in'sentiv/	n.刺激;动力;鼓励;诱因;动机
inch	/intʃ/	n.英寸
incidence	/'insidəns/	n.影响程度,影响范围;发生率
incident	/'insidənt/	n.事件,事变
incidentally	/,insi'dentəli/	ad.附带地,顺便提及
incline	/in'klain/	v.(使)倾斜;(使)倾向于n.斜坡,斜面
include	/in'klu:d/	v.包括,包含,计入
inclusive	/in'klu:siv/	a.(of)包括的,包含的;范围广的
income	/'inkʌm/	n.收入,收益,所得
incorporate	/in'kɔ:pəreit/	v.合并,纳入,结合a.合并的
increase	/in'kri:s,'inkri:s/	v./n.增加,增长,增进
increasingly	/in'kri:siŋli/	ad.不断增加地,日益
incredible	/in'kredəbl/	a.不可相信的,惊人的,不可思议的
incur	/in'kə:/	v.招致,惹起,遭受
indeed	/in'di:d/	ad.确实,实在;真正地,多么
independence	/,indi'pendəns/	n.独立,自主
independent	/,indi'pendənt/	a.(of)独立的,自主的
index	/'indeks/	n.(pl.indexes,indices)索引v.附以索引
indicate	/'indikeit/	v.指出,指示;表明,暗示
indication	/,indi'keiʃən/	n.指出,指示;表明,暗示
indicative	/in'dikətiv/	a.(of)指示的,暗示的
indifferent	/in'difərənt/	a.冷漠的,不关心的,不积极的
indignant	/in'diɡnənt/	a.愤慨的,愤慨不平的
indignation	/,indiɡ'neiʃən/	n.愤怒,愤慨
indispensable	/,indis'pensəbl/	a.(to,for)必不可少的,必需的
individual	/,indi'vidjuəl,-dʒəl/	a.个人的,单独的;独特的n.个人,个体
indoor	/'indɔ:/	a.室内的,户内的
induce	/in'dju:s,in'du:s/	v.引诱,劝使;引起,导致;感应
indulge	/in'dʌldʒ/	v.放任,纵容,沉溺;使(自己)纵情享受
industrial	/in'dʌstriəl/	a.工业的,产业的
industrialize	/in'dʌtriəlaiz/	v.(industrialise)(使)工业化
industry	/'indəstri/	n.工业,产业;勤劳,勤奋
inertia	/i'nə:ʃiə/	n.不活动,惰性;惯性
inevitable	/in'evitəbl/	a.不可避免的,必然发生的
infant	/'infənt/	n.婴儿,幼儿
infect	/in'fekt/	vt.传染,感染;影响(思想等)
infectious	/in'fekʃəs/	a.传染的,传染性的,有感染力的
infer	/in'fə:/	v.推论,推断
inference	/'infərəns/	n.推论,推理,推断;结论
inferior	/in'fiəriə/	a.下等的,下级的;劣等的,差的n.下级,晚辈
infinite	/'infinət/	a.无限的,无穷的n.无限
inflation	/in'fleiʃən/	n.通货膨胀
influence	/'influəns/	n.(on)影响,感化;势力,权势v.影响,感化
influential	/,influ'enʃəl/	a.有影响的;有权势的
inform	/in'fɔ:m/	v.(of,about)通知,告诉,报告;告发,告密
information	/,infə'meiʃən/	n.通知,报告;情报,资料,消息;信息
infrared	/,infrə'red/	a./n.红外线(的)
infrastructure	/'infrə,strʌktʃə/	n.基础结构,基础设施
ingenious	/in'dʒi:njəs/	a.机敏的;有独创性的;精致的;精巧制成的
ingredient	/in'ɡri:diənt/	n.(混合物的)组成部分,配料;成份,要素
inhabit	/in'hæbit/	vt.居住于,存在于;栖息于
inhabitant	/in'hæbitənt/	n.居民,住户
inhale	/in'heil/	v.吸入(气体等),吸(烟)
inherent	/in'hiərənt/	a.固有的,内在的,天生的
inherit	/in'herit/	vt.继承(金钱等),经遗传而得(性格、特征)
inhibit	/in'hibit/	vt.抑制,约束
initial	/i'niʃəl/	a.最初的,开头的;词首的n.词首大写字母
initiate	/i'niʃieit,i'niʃiət,-eit/	vt.开始,创始,发动;启蒙,使入门;引入
initiative	/i'niʃiətiv,-ʃətiv/	a.创始的,起始的n.第一步,创始,主动精神
inject	/in'dʒekt/	vt.注射(药液等);注入
injure	/'indʒə/	v.损害,损伤,伤害
injury	/'indʒəri/	n.伤害,损害
ink	/iŋk/	n.墨水,油墨
inland	/'inlənd,-lænd/	a./ad.国内,内地,内陆
inlet	/'inlet,-lit,in'let/	n.水湾,小湾;进口,入口
inn	/in/	n.小旅馆,客栈
inner	/'inə/	a.内部的,里面的;内心的
innocent	/'inəsənt/	a.(of)清白的,无罪的;无害的;单纯的,无知的
innovation	/,inəu'veiʃən/	n.改革,革新;新观念,新方法,新发明
innumerable	/i'nuj:mərəbl/	a.无数的,数不清的
input	/'input/	n./v.输入
inquiry	/in'kwaiəri/	n.(enquiry)询问,打听,调查
insect	/'insekt/	n.昆虫
insert	/in'sə:t,'insə:t/	v.插入,嵌入;登载n.插入物
inside	/,in'said,'in-/	a.里面的ad.在里面n.内部prep.在…里
insight	/'insait/	n.洞察力,见识
insist	/in'sist/	vi.(on)坚持要求,坚决主张,坚持
inspect	/in'spekt/	vt.检查,调查,视察
inspiration	/,inspə'reiʃən/	n.灵感;鼓舞,激励
inspire	/in'spaiə/	vt.鼓舞,激起;使产生灵感
install	/in'stɔ:l/	vt.(instal)安装,设置,安置;使就职,任命
installation	/,instə'leiʃən/	n.安装,设置;装置,设备
installment	/in'stɔ:lmənt/	n.(instalment)分期付款;(连载的)一期
instance	/'instəns/	n.例子,事例,例证
instant	/'instənt/	a.立即的;紧迫的;(食品)速溶的n.瞬间,时刻
instantaneous	/,instən'teinjəs/	a.瞬间的,即刻的
instead	/in'sted/	ad.代替,顶替
instinct	/'instiŋkt/	n.本能,直觉,天性
institute	/'institjut,-tu:t/	n.学会,研究所;学院v.设立,设置,制定
institution	/,insti'tju:ʃən/	n.公共机构;协会;学校;研究所;制度;惯例
instruct	/in'strʌkt/	v.教,教授;命令,指示
instruction	/in'strʌkʃən/	n.教授;指导;(pl.)用法说明(书),操作指南
instrument	/'instrumənt/	n.工具,仪器,器械;乐器
instrumental	/,instru'mentəl/	a.仪器的;器械的;乐器的;起作用的;有帮助的
insulate	/'insjuleit,'insə-/	vt.隔离,孤立;使绝缘,使绝热
insult	/in'sʌlt/	vt./n.侮辱,凌辱
insurance	/in'ʃuərəns/	n.保险,保险费,保险业
insure	/in'ʃuə/	vt.保险,给…保险;保证
intact	/in'tækt/	a.完整无缺的,未经触动的,未受损伤的
integral	/'intiɡrəl/	a.构成整体所必需的;完整的
integrate	/'intiɡreit/	v.(into,with)(使)成为一体,(使)结合在一起
integrity	/in'teɡrəti/	n.正直,诚实;完整,完全
intellectual	/,intə'lektjuəl/	n.知识分子a.智力的,理智的,有理解力的
intelligence	/in'telidʒəns/	n.智力,聪明;理解力;情报,消息,报导
intelligent	/in'telidʒent/	a.聪明的,明智的,理智的
intelligible	/in'telidʒəbl/	a.可理解的,明白易懂的,清楚的
intend	/in'tend/	vt.想要,打算,企图
intense	/in'tens/	a.强烈的,剧烈的;热烈的,热情的
intensity	/in'tensəti/	n.强烈,剧烈;强度
intensive	/in'tensiv/	a.加强的,集中的,深入细致的,精耕细作的
intention	/in'tenʃən/	n.意图,意向,目的
interact	/'intərækt/	v.互相作用,互相影响
intercourse	/'intəkɔ:s/	n.交流,交往,交际,性交
interest	/'intrist,'intər-/	n.(in)兴趣,重要性;利益v.(in)使发生兴趣
interesting	/'intristiŋ,'intər-/	a.有趣的,引人入胜的
interface	/'intəfeis/	n.接合部位,分界面v.(使)互相联系
interfere	/,intə'fiə/	v.(in)干涉,干预;(with)妨碍,打扰
interference	/,intə'fiərəns/	n.(in)干涉,干预;(with)妨碍,打扰
interim	/'intərim/	a.中间的,暂时的,临时的n.过渡时期,暂定
interior	/in'tiəriə/	a.内部的,里面的n.内部,内地
intermediate	/,intə'mi:djət,-dieit/	a.中间的,居间的;中级的n.中间体,媒介物
intermittent	/,intə'mitənt/	a.间歇的,断断续续的
internal	/in'tə:nəl/	a.内部的,内的;国内的,内政的
international	/,intə'næʃənəl/	a.国际的,世界(性)的,跨国的
internet	/'intənet/	n./the～/国际互联网,因特网
interpret	/in'tə:prit/	vt.解释,说明;口译
interrupt	/ˌɪntəˈrʌpt/	v.中断,遮断,阻碍;打断(话),打扰
intersection	/,intə'sekʃən/	n.相交,交叉;道路交叉口,十字路口
interval	/'intəvəl/	n.间隔,间歇;(幕间或工间)休息
intervene	/,intə'vi:n/	v.(in)干涉,干预;插入,介入
interview	/'intəvju:/	v./n.接见,会见;采访;面试
intimate	/'intimət/	a.亲密的,密切的n.熟友,熟人
intimidate	/in'timideit/	vt.胁迫,威胁(某人做某事)
into	/'intu:,-tu,-tə/	prep.到...里面,进入;成为(表示变化)
intricate	/'intrikət/	a.复杂的,错综的,难以理解的
intrigue	/in'tri:ɡ,'in-/	n.阴谋v.密谋,私通;激起…的兴趣;诡计取得
intrinsic	/in'trinsik,-kəl/	a.(指价值、性质)固有的,本质的,内在的
introduce	/,intrə'dju:s/	vt.介绍;引进,传入;提出(议案等)
introduction	/,intrə'dʌkʃən/	n.(to)介绍;传入,引进;导言,导论,绪论
intrude	/in'tru:d/	vi.闯入,侵入vt.把(思想等)强加于人;强挤入
intuition	/,intju:'iʃən/	n.直觉,直观;凭直觉而知的事物
invade	/in'veid/	vt.入侵,侵略,侵袭,侵扰
invalid	/'invəli:d/	n.病人,伤残人/ɪnˈvælɪd/a.有病的,伤残的;无效的
invaluable	/in'væljuəbl/	a.非常宝贵的,无价的
invariably	/ɪnˈveriəbli/	ad.不变地,永恒地,总是
invasion	/in'veiʒən/	n.入侵,侵略,侵犯
invent	/in'vent/	v.发明,创造;捏造,虚构
invention	/in'venʃən/	n.发明,创造,发明物
inventory	/'invəntəri,-tɔ:ri/	n.详细目录,存货,财产清册,总量
inverse	/'invə:s,in'v-,in'və:s/	a.相反的,倒转的,反转的n.相反之物v.倒转
invert	/in'və:t,'invə:t/	v.倒置,倒转,颠倒
invest	/in'vest/	vt.投资,投入(精力、时间等)
investigate	/in'vestiɡeit/	v.调查,调查研究
investment	/in'vestmənt/	n.投资,投资额
invisible	/in'vizəbl/	a.看不见的,无形的
invitation	/,invi'teiʃən/	n.邀请,招待;请柬
invite	/in'vait,'invait/	vt.邀请,招待
involve	/in'vɔlv/	v.卷入,陷入,连累;包含,含有,涉及
inward	/'inwəd/	ad.向内,在内a.向内的,在内的,里面的
iron	/'aiən/	n.铁,铁制品,烙铁,熨斗v.熨(衣),熨平
irony	/'aiərəni/	n.反话,讽刺,讽刺之事
irrespective	/,iri'spektiv/	a.不顾的,不考虑的,无关的
irrigate	/'iriɡeit/	vt.灌溉,修水利vi.进行灌溉
irritate	/'iriteit/	vt.激怒,恼火,使急躁
island	/'ailənd/	n.岛,岛屿;(道路上的)交通安全岛
isle	/ail/	n.小岛(用于诗歌中)
isolate	/'aisəleit,-lit/	vt.隔离,孤立
issue	/'iʃju:,'isju:/	n.问题,争端,发行(物),期号vt.发行,流出
it	/it/	pron.它;/作无人称动词的主语/
item	/'aitəm/	n.条(款),项目;一则(新闻),(戏剧的)节目
its	/its/	pron./it的所有格/它的
itself	/it'self/	pron.(it的反身代词)它自己,它本身
jacket	/'dʒækit/	n.短上衣,茄克衫
jam	/dʒæm/	n.阻塞,轧住;果酱v.(使)阻塞,(使)轧住不动
January	/ˈdʒænjueri/	n.一月
jar	/dʒɑ:/	n.罐坛,广口瓶
jargon	/'dʒɑ:ɡən,-ɡɔn/	n.行话
jaw	/dʒɔ:/	n.颌,颚
jazz	/dʒæz/	n.爵士乐
jealous	/'dʒeləs/	a.(of)妒忌的;猜疑的,警惕的
jeans	/dʒiːnz/	n.牛仔裤（又称bluejeans,dungarees等）
jet	/dʒet/	n.喷气发动机,喷气式飞机;喷口v.喷出,喷射
jewel	/'dʒu:əl/	n.宝石,宝石饰物
jewelry	/'dʒu:əlri/	n.(jewllery)(总称)珠宝
job	/dʒɔb/	n.工作,职位;零活,一件工作;任务,职责
jog	/dʒɔɡ/	v.慢跑
join	/dʒɔin/	v.参加,加入;联合,连接;和…在一起
joint	/dʒɔint/	n.接合处,接头;关节a.联合的,共同的,连接的
joke	/dʒəuk/	n.笑话,玩笑v.说笑话,开玩笑
jolly	/'dʒɔli/	a.欢乐的,高兴的
journal	/'dʒə:nəl/	n.定期刊物,杂志,日报;日志,日记
journalist	/'dʒə:nəlist/	n.记者,新闻工作者
journey	/'dʒə:ni/	n.旅行,旅程v.旅行
joy	/dʒɔi/	n.欢乐,喜悦;乐事,乐趣
judge	/dʒʌdʒ/	n.法官;裁判员;鉴定人vt.审判;评论,裁判
judgement	/'dʒʌdʒmənt/	n.(judgment)审判,判决;判断(力);看法,意见
judicial	/dʒu:'diʃəl/	a.司法的,法庭的,审判的;明断的,公正的
jug	/dʒʌɡ/	n.(有柄,小口,可盛水等的)大壶,罐,盂
juice	/dʒu:s/	n.(水果等)汁,液
July	/dʒuˈlaɪ/	n.七月
jump	/dʒʌmp/	v./n.跳跃,跳动,跳过;暴涨,猛增
junction	/'dʒʌŋkʃən/	n.连接,接合,交叉点,枢纽站,接头,中继线
June	/dʒuːn/	n.六月
jungle	/'dʒʌŋɡl/	n.丛林,生死地带
junior	/'dʒu:njə/	a./n.年少的/者,三年级的/学生,下级(的)
junk	/dʒʌŋk/	n.废物,旧货;舢板
jury	/'dʒuəri/	n.陪审团;全体评审员
just	/dʒʌst/	ad.正好地;刚才;只不过a.公正的,公平的
justice	/'dʒʌstis/	n.公正,公平;审判,司法
justify	/'dʒʌstifai/	v.证明...正当(或有理、正确),为...辩护
juvenile	/'dʒu:vənail,-nil/	n.青少年,少年读物a.青少年的,幼稚的
keen	/ki:n/	a.锋利的;敏锐的;敏捷的;(on)热心的,渴望的
keep	/ki:p/	v.保持,保存,遵守,经营,看守,拘留,维持
kettle	/'ketl/	n.水壶
key	/ki:/	n.钥匙;答案;关键;键a.主要的,关键的
keyboard	/'ki:bɔ:d/	n.键盘vt.用键盘输入(信息)
kick	/kik/	n./v.踢
kid	/kid/	n.小孩,儿童v.戏弄,取笑
kidnap	/'kidnæp/	vt.诱拐;绑架,劫持
kidney	/'kidni/	n.肾,肾脏
kill	/kil/	vt.杀死,消灭;破坏,毁灭;消磨(时间)
kilo	/'ki:ləu,'ki-/	n.(kilogram/kilogramme)千克
kilometer	/ˈkɪləˌmitɚ; kəˈlɑmətɚ/	n.(kilometer)公里,千米(略作km)
kin	/kin/	n.家族,亲属,血缘关系a.亲属关系的,同类的
kind	/kaind/	a.仁慈的,友好的,亲切的,和蔼n.种类
kindergarten	/ˈkɪndərɡɑːrtn/	n.幼儿园
kindness	/'kaindnis/	n.仁慈,亲切;好意;友好行为
king	/kiŋ/	n.君主,国王
kingdom	/'kiŋdəm/	n.王国,领域
